NO ./TEXTURES/Cannabis.xpm
SO ./TEXTURES/Blackhole.xpm
WE ./TEXTURES/Sunset.xpm
EA ./TEXTURES/Jul.xpm

F 30,30,30
C 0,114,255

        1111111111111111111111111
        1000000000110000000000001
        1011000001110000000000001
        10010000000000000000000001
111111111011000001110000000000001
100000000011000001110111111111111
11110111111111011100000010001
11110111111111011101010010001
11111111111111111111111100111
11111111111111111111111111111
10011111111111111111110001111
11000000110101011100000010001
10000000000000001100000010001
1000000000000000110101001000W1
11000001110101011111011110001
1111011101110101001111010001
11111111011111110111111111111
100000000000000000000000001
111111111111111111111111111
