NO TEXTURES/north.xpm
SO TEXTURES/south.xpm
WE TEXTURES/west.xpm
EA TEXTURES/east.xpm

F 20,20,20
C 200,200,200

111111111111111111111
1000000000000000000E1
111111111111111111111
